G;G;G;G;G;G;G;G;G;G;G;G;G;G;G;G;G;G;G;G;G;G;G;G;G;G;G;G;G;G
G;G;G;G;G;G;G;G;G;G;G;G;G;G;G;G;G;G;G;G;G;G;G;G;G;G;G;G;G;G
G;G;G;G;G;G;G;G;G;G;G;G;G;G;G;G;G;G;G;G;G;G;G;G;G;G;G;G;G;G
G;G;G;G;G;G;G;G;G;G;G;G;G;G;G;G;G;G;G;G;G;G;G;G;G;G;G;G;G;G
G;G;G;G;G;G;G;G;G;G;G;G;G;G;G;G;G;G;G;G;G;G;G;G;G;G;G;G;G;G
G;G;G;G;G;G;G;G;G;G;G;G;G;G;R;R;R;R;G;G;G;G;G;G;G;G;G;G;G;G
G;G;G;G;G;G;G;G;G;G;G;G;G;G;R;G;H;R;G;G;G;G;G;G;G;G;G;G;G;G
G;G;G;G;G;H;R;R;R;R;R;R;G;G;R;G;G;R;G;G;G;G;G;G;G;G;G;G;G;G
G;G;G;G;G;G;R;G;G;G;G;R;G;G;R;G;G;R;G;G;G;G;G;G;G;G;G;G;G;G
G;G;G;G;G;G;R;G;G;G;G;R;G;G;R;G;G;R;G;G;G;G;G;G;G;G;G;G;G;G
G;G;G;G;G;G;R;G;G;G;G;R;G;G;R;G;G;R;G;G;G;G;G;G;G;G;G;G;G;G
G;G;G;G;G;G;R;G;G;G;G;R;G;G;R;G;G;R;G;G;G;G;G;G;G;G;G;G;G;G
G;G;G;G;G;G;R;G;G;G;G;R;G;G;R;G;G;R;G;G;G;G;G;G;G;G;G;G;G;G
G;G;G;G;G;G;R;G;G;G;G;R;G;G;R;G;G;R;G;G;R;R;R;R;R;R;G;G;G;G
G;G;G;G;G;G;R;R;R;R;R;R;R;R;R;G;G;R;G;G;R;G;G;G;G;R;G;G;G;G
G;G;G;G;G;G;G;G;R;G;G;G;G;G;R;G;G;R;G;G;R;G;G;G;G;R;G;G;G;G
G;G;G;G;G;G;G;G;R;G;G;G;G;G;R;G;G;R;G;G;R;G;G;G;G;R;G;G;G;G
G;G;G;G;G;G;G;G;R;G;G;G;G;G;R;G;G;R;G;G;R;G;G;G;G;R;G;G;G;G
G;G;G;G;G;G;G;G;R;G;G;G;G;G;R;G;G;R;G;G;R;G;G;G;G;R;G;G;G;G
G;G;G;G;G;G;G;G;R;G;G;G;G;G;R;R;R;R;H;G;R;G;G;GD;G;R;G;G;G;G
G;G;G;G;G;G;G;G;R;G;G;G;G;G;G;G;G;G;G;G;R;R;R;R;G;R;G;G;G;G
G;G;G;G;G;G;G;G;R;G;G;G;G;G;G;G;G;G;G;G;G;G;G;G;G;R;G;G;G;G
G;G;G;G;G;G;G;G;R;G;G;G;G;G;G;G;G;G;G;G;G;G;G;G;G;R;G;G;G;G
G;G;G;G;G;G;G;G;R;G;G;G;G;G;G;G;G;G;G;G;G;G;G;G;G;R;G;G;G;G
G;G;G;G;G;G;G;G;R;R;R;R;R;R;R;R;R;R;R;R;R;R;R;R;R;R;R;H;G;G
G;G;G;G;G;G;G;G;G;G;G;G;G;G;G;G;G;G;G;G;G;G;G;G;G;G;G;G;G;G
G;G;G;G;G;G;G;G;G;G;G;G;G;G;G;G;G;G;G;G;G;G;G;G;G;G;G;G;G;G
G;G;G;G;G;G;G;G;G;G;G;G;G;G;G;G;G;G;G;G;G;G;G;G;G;G;G;G;G;G
G;G;G;G;G;G;G;G;G;G;G;G;G;G;G;G;G;G;G;G;G;G;G;G;G;G;G;G;G;G
G;G;G;G;G;G;G;G;G;G;G;G;G;G;G;G;G;G;G;G;G;G;G;G;G;G;G;G;G;G
;;;;;;;;;;;;;;;;;;;;;;;;;;;;;
;;;;;;;;;;;;;;;;;;;;;;;;;;;;;
;;;;;;;;;;;;;;;;;;;;;;;;;;;;;
;;;;;;;;;;;;;;;;;;;;;;;;;;;;;
