G;G;G;G;G;G;G;G;G;G;G;G;G;G;G;G;G;G;G;G;G;G;G;G;G;G;G;G;G;G
G;G;G;G;G;G;G;G;G;G;G;G;G;G;G;G;G;G;G;G;G;G;G;G;G;G;G;G;G;G
G;G;G;G;G;G;G;G;G;G;G;G;G;G;G;G;G;G;G;G;G;G;G;G;G;G;G;G;G;G
G;G;G;G;G;G;G;G;G;G;G;G;G;G;G;G;G;G;G;G;G;G;G;G;G;G;G;G;G;G
G;G;G;G;G;G;G;G;G;G;G;G;G;G;G;G;G;G;G;G;G;G;G;G;G;G;G;G;G;G
G;G;G;G;G;G;G;G;G;G;G;G;G;G;G;G;G;G;G;G;G;G;G;G;G;G;G;G;G;G
G;G;G;G;G;G;R;R;R;R;R;R;R;R;R;R;R;R;R;R;R;R;R;R;R;R;R;G;G;G
G;G;G;G;G;G;R;G;G;G;R;G;G;G;G;G;G;R;G;G;G;G;G;G;G;G;R;G;G;G
G;G;G;G;G;G;R;G;G;G;R;G;G;G;G;G;G;R;G;G;G;G;G;G;G;G;R;G;G;G
G;G;G;G;H;G;R;G;G;G;R;G;G;G;G;G;G;R;G;G;G;G;G;G;G;G;R;G;G;G
G;G;R;R;R;G;R;G;G;G;R;R;R;R;R;G;G;R;G;G;G;G;G;G;G;G;R;G;G;G
G;G;R;G;G;G;R;G;G;G;G;G;G;G;R;G;G;R;R;R;R;R;R;R;R;H;R;G;G;G
G;G;R;G;G;G;R;G;G;G;G;G;G;G;R;G;G;G;G;G;G;G;G;G;G;G;R;G;G;G
G;G;R;G;G;G;R;G;G;G;G;G;G;G;R;G;G;G;G;G;G;G;G;G;G;G;R;G;G;G
G;G;R;G;G;G;R;G;G;G;G;G;G;G;R;R;R;R;R;R;R;R;R;R;R;G;R;G;G;G
G;G;R;G;G;G;R;G;G;G;G;G;G;G;R;G;G;G;G;G;G;G;G;G;R;G;R;G;G;G
G;G;R;R;R;R;R;G;G;G;G;G;G;G;R;G;G;G;G;G;G;G;G;G;R;G;R;G;G;G
G;G;G;G;G;G;G;G;G;G;G;G;G;G;R;G;G;G;G;G;G;G;G;G;R;G;H;G;G;G
G;G;G;G;G;G;G;G;G;G;G;G;G;G;R;G;G;G;G;G;G;G;G;G;R;G;G;G;G;G
G;G;G;G;G;G;G;G;G;G;G;G;G;G;H;G;G;G;G;G;G;G;G;G;R;G;G;G;G;G
G;G;G;G;G;G;G;G;G;G;G;G;G;G;G;G;G;G;G;G;G;G;G;G;R;G;G;G;G;G
G;G;G;G;G;G;G;G;G;G;G;G;GD;R;R;R;R;R;R;R;R;R;R;R;R;G;G;G;G;G
G;G;G;G;G;G;G;G;G;G;G;G;G;G;G;G;G;G;G;G;G;G;G;G;G;G;G;G;G;G
G;G;G;G;G;G;G;G;G;G;G;G;G;G;G;G;G;G;G;G;G;G;G;G;G;G;G;G;G;G
G;G;G;G;G;G;G;G;G;G;G;G;G;G;G;G;G;G;G;G;G;G;G;G;G;G;G;G;G;G
G;G;G;G;G;G;G;G;G;G;G;G;G;G;G;G;G;G;G;G;G;G;G;G;G;G;G;G;G;G
G;G;G;G;G;G;G;G;G;G;G;G;G;G;G;G;G;G;G;G;G;G;G;G;G;G;G;G;G;G
G;G;G;G;G;G;G;G;G;G;G;G;G;G;G;G;G;G;G;G;G;G;G;G;G;G;G;G;G;G
G;G;G;G;G;G;G;G;G;G;G;G;G;G;G;G;G;G;G;G;G;G;G;G;G;G;G;G;G;G
G;G;G;G;G;G;G;G;G;G;G;G;G;G;G;G;G;G;G;G;G;G;G;G;G;G;G;G;G;G
;;;;;;;;;;;;;;;;;;;;;;;;;;;;;
;;;;;;;;;;;;;;;;;;;;;;;;;;;;;
;;;;;;;;;;;;;;;;;;;;;;;;;;;;;
;;;;;;;;;;;;;;;;;;;;;;;;;;;;;
