G;G;G;G;G;G;G;G;G;G;G;G;G;G;G;G;G;G;G;G;G;G;G;G;G;G;G;G;G;G
G;G;G;G;G;G;G;G;G;G;G;G;G;G;G;G;G;G;G;G;G;G;G;G;G;G;G;G;G;G
G;G;G;G;G;G;G;G;G;G;G;G;G;G;G;G;G;G;G;G;G;G;G;G;G;G;G;G;G;G
G;G;G;G;R;R;R;G;R;R;R;G;R;R;R;G;G;G;G;G;G;G;G;G;G;G;G;G;G;G
G;G;G;G;R;G;R;G;R;G;R;G;R;G;R;G;G;G;G;G;G;G;G;G;G;G;G;G;G;G
G;G;G;G;R;G;R;G;R;G;R;G;R;G;R;G;G;G;G;G;G;G;G;G;G;G;G;G;G;G
G;G;G;G;R;G;R;G;R;G;R;G;R;G;R;G;G;G;G;G;G;G;G;G;G;G;G;G;G;G
G;G;G;G;R;G;R;G;R;G;R;G;R;G;R;G;G;G;G;G;G;G;G;G;G;G;G;G;G;G
G;G;G;G;R;G;R;G;R;G;R;G;R;G;R;G;G;G;G;G;G;G;G;G;G;G;G;G;G;G
G;G;G;G;R;G;R;G;R;G;R;G;R;G;R;G;G;G;G;G;G;G;G;G;G;G;G;G;G;G
G;G;G;G;R;G;R;G;R;G;R;G;R;G;R;G;G;G;G;G;G;G;G;G;G;G;G;G;G;G
G;G;G;G;R;G;R;G;R;G;R;G;R;G;R;G;G;G;G;G;G;G;G;G;G;G;G;G;G;G
G;G;G;G;R;G;R;G;R;G;R;G;R;G;R;G;G;G;G;G;G;G;G;G;G;G;G;G;G;G
G;G;G;G;R;G;R;G;R;G;R;G;R;G;R;G;G;G;G;G;G;G;G;G;G;G;G;G;G;G
G;G;G;G;R;G;R;G;R;G;R;G;R;G;R;G;G;G;G;G;G;G;G;G;G;G;G;G;G;G
G;G;G;G;R;G;R;R;R;R;R;R;R;G;R;G;G;G;G;G;G;G;G;G;G;G;G;G;G;G
G;G;G;G;R;G;H;G;G;H;G;G;H;G;R;G;G;G;G;G;G;G;G;G;G;G;G;G;G;G
G;G;G;G;R;G;G;G;G;G;G;G;G;G;R;G;G;G;G;G;G;G;G;G;G;G;G;G;G;G
G;G;G;G;R;G;G;G;G;G;G;G;G;G;R;G;G;G;G;G;G;G;G;G;G;G;G;G;G;G
G;G;G;G;R;G;G;G;G;G;G;G;G;G;R;G;G;G;G;G;G;G;G;G;G;G;G;G;G;G
G;G;G;G;R;G;G;G;G;G;G;G;G;G;R;G;G;G;G;G;G;G;G;G;G;G;G;G;G;G
G;G;G;G;R;H;G;G;G;G;G;G;G;H;R;G;G;G;G;G;G;G;G;G;G;G;G;G;G;G
G;G;G;G;R;R;R;R;R;R;R;R;R;R;R;G;G;G;G;G;G;G;G;G;G;G;G;G;G;G
G;G;G;G;G;G;G;G;G;GD;G;G;G;G;G;G;G;G;G;G;G;G;G;G;G;G;G;G;G;G
G;G;G;G;G;G;G;G;G;G;G;G;G;G;G;G;G;G;G;G;G;G;G;G;G;G;G;G;G;G
G;G;G;G;G;G;G;G;G;G;G;G;G;G;G;G;G;G;G;G;G;G;G;G;G;G;G;G;G;G
G;G;G;G;G;G;G;G;G;G;G;G;G;G;G;G;G;G;G;G;G;G;G;G;G;G;G;G;G;G
G;G;G;G;G;G;G;G;G;G;G;G;G;G;G;G;G;G;G;G;G;G;G;G;G;G;G;G;G;G
G;G;G;G;G;G;G;G;G;G;G;G;G;G;G;G;G;G;G;G;G;G;G;G;G;G;G;G;G;G
G;G;G;G;G;G;G;G;G;G;G;G;G;G;G;G;G;G;G;G;G;G;G;G;G;G;G;G;G;G
